F 220,100,0


EA ./path_to_the_east_texture
C 225,30,0


WE ./path_to_the_west_texture
SO ./path_to_the_south_texture
NO ./path_to_the_north_texture


   11111111111
   1W00000001
   1110000111
     100001
     111101111
        100001
        111111

Ok :

11111  111
10W0111101
1000000001
1111111111

    1111
1111100111
10W0111101
1000000001
1111111111

1111
   11111
   1W001
  111111
       1111

Not ok :

11111
  1W0000001
11111

1111100111
10W0111101
1000000001
1111111111
