Valid maps :

11111  111
10W0111101
1000000001
1111111111

    1111
1111100111
10W0111101
1000000001
1111111111

1111
   11111
   1W001
  111111
       1111

111
1W1
111

Invalid maps :

1111
1001
1111

11111
  1W0000001
11111

1111100111
10W0111101
1000000001
1111111111

W11111
100001
111111
